11111111111111111111
1E0000000C000000P0P1
11111111111111111111