11111111111111111111
1PC1C01000000C010C01
101C10001111C1C1C1C1
1C101011C0C101010101
101010C10101C1C1C1C1
10101101C1C101010101
1C0000010111C1C1C1C1
111111110C1001010101
1EC0C0C0C0C0C1C0C1C1
11111111111111111111