11111111111111111
1E000000C000000P1
11111111111111110