111111111111111111
1E00000000C00000P11
111111111111111111