1111111111111111
1E00000000000001
10000C00000X00P1
1111111111111111