11111111111
100000C00P1
11111111111